





               NO           ./path_to_the_north_texture   

         SO            ./path_to_the_south_texture             


C             120     ,                  20,                   20


  WE                  ./path_to_the_west_texture


     EA      ./path_to_the_east_texture


F             10                 ,      10         ,                10



                   
                      
                       
                       
                
          11           111
          1111111      101
          1011         101
          10011        101
11111111111000111111111101
10000110000000000000000001
11111111111111111111111111
1111111111N001111111111111   11111111
         11100001           111000011
          1000011111     11110000001
          10000000011111 10000000001
          11001001000001110000011101
          10111111000000000100000101
          10000000000000000000111101
          10110110000000111100011111
          110001111111111  11011
           11011           11111
            111
                
                         
                          