          NO ./path_to_the_north_texture


         SO            ./path_to_the_south_texture


          F       220       ,       100,0


WE ./path_to_the_west_texture





EA            ./path_to_the_east_texture







C 225        ,    130   ,    0              

11
1111111
1011
10011
100011111111
100000000001
1N001111111111
100001
1000011111
10000000011111
1100100100001
10111111000001
101  1000000011
111  1111111111