NO assets/nord.xpm
SO assets/sud.xpm
WE assets/ouest.xpm
EA assets/est.xpm

F 47,127,77
C 119,181,254

11111111111111111111111111111
10000000000001110000000000001
10000000000001110000000000001
10000000000001110000000000001
10000000000001110000000000001
10000000000001110000000000001
1000000E000001110000000000001
10000000000001110000000000001
10000000000001110000000000001
10000000000001110000000000001
10000000000001110000000000001
10000000000001110000000000001
10000000000001110000000000001
11111111111111111111111111111