NO assets/nord.xpm
SO assets/sud.xpm
WE assets/ouest.xpm
EA assets/est.xpm

F 47,127,77
C 119,181,254

11111111111111111111111111111
100011111
100000001
100N00001
101100001
100011111
10001
10001
10001
10001
10001
10001
10001
11111111111111111111111111111