
     NO    assets/nord.xpm
   C  4 , 41 , 44   

 EA    assets/est.xpm
  F    +4  , 0255 ,  4
   SO    assets/sud.xpm


WE assets/ouest.xpm


111111
100101
101001
1100N1
111111