NO             assets/nord.xpm
                SO                     assets/sud.xpm


            EA                 assets/est.xpm

WE     assets/ouest.xpm

F 47,127,77
C 119,181,254


          11           111
          1111111 11111101
          1011         101
          10011        101
11111111111000111111111101111
11111111111111111111100111
1111111111111111111111111111111111
        111
111111111011111111111111
        111
111111111111111111111111111111111111111111111111
111
 
111111111111111111111111111111111111111111111111
11111111111110000000000000111111111111111
1111111111111111111111111111111
10000110000000000000000001
11111111111111111111111111   11111111
         11100001      1111 111000011
          1000011111     111100000011
          10000000011111 10000000001
          11001001000001110000011101
          10111111000000000100000101
          111111111111111111111111111111
          111    11011111111111111111
          1111111110111000000000011111111111111111
       1111111111111111111111111111111111111
          10000000110N00000000111101
          10110110110000111100011111
          110001111111111  11011                                        1111
           11011           11111                                        111
            11111                                                    111
                    111                                             11 1
                    101                                              1111
                    101             11111111111111111
                    101                 111 1
                    111111
                    101             11
                    101            1
                    101
                    101
                    111